20 20
70 50
4 6 4 2 4 4 4 4 4 4 4 4 4 4 4 4 4 2 4 4
4 8 8 2 3 0 0 0 0 0 0 0 0 0 3 2 2 2 0 4
4 8 8 2 0 0 4 3 3 3 0 3 3 0 0 0 0 2 0 4
4 0 0 0 0 0 4 0 0 3 0 3 3 3 3 3 3 2 0 4
4 0 0 2 0 3 4 0 0 3 3 3 0 0 0 0 0 2 0 4
4 0 0 2 0 3 4 0 0 0 0 0 0 4 0 4 0 0 0 4
4 0 0 0 0 3 4 0 0 2 2 2 2 4 4 4 0 4 4 4
4 3 0 3 0 0 0 0 0 2 0 2 0 0 0 0 0 0 0 4
4 0 0 3 0 3 4 0 0 2 2 2 0 2 2 0 2 2 0 4
4 0 3 3 0 3 4 0 2 2 0 0 0 0 2 2 0 0 0 4
4 0 0 3 0 0 0 0 0 2 0 0 4 0 0 2 2 2 2 4
4 3 0 2 0 3 4 4 0 0 0 0 4 0 0 0 4 0 0 4
4 3 0 3 0 3 4 0 4 0 0 0 3 3 3 4 4 4 0 4
4 3 0 0 0 3 4 0 0 4 4 0 4 0 0 0 4 0 0 4
4 0 0 0 0 3 4 0 0 0 0 0 0 0 4 0 0 0 0 4
4 0 4 4 4 4 0 0 5 5 4 0 0 3 3 4 4 4 4 4
4 0 4 5 0 3 4 0 5 5 5 4 0 0 0 0 0 0 0 4
4 0 0 0 0 0 5 2 2 2 2 2 0 3 0 0 4 8 8 4
4 0 0 4 0 0 5 2 2 2 2 2 0 3 0 0 4 8 8 4
4 4 4 4 4 4 4 4 4 2 4 4 4 4 4 4 4 7 4 4
